Frank Darabont --> The Shawshank Redemption - The Green Mile
Michel Gondry --> Eternal Sunshine Of The Spotless Mind
Christopher Nolan --> The Dark Knight - Inception - Interstellar - The Prestige - Memento - The Dark Knight Rises
Robert Zemeckis --> Forrest Gump - Cast Away
Guy Ritchie --> Snatch - The Gentlemen
Sidney Lumet --> 12 Angry Men
David Fincher --> Fight Club - Se7En - The Curious Case Of Benjamin Button - Gone Girl - Zodiac
Justin Baldoni --> Five Feet Apart
Jessie Nelson --> I'M Sam
Bryan Singer --> The Usual Suspects
Josh Boone --> The Fault In Our Stars
Martin Scorsese --> Shutter Island - Taxi Driver - The Wolf Of Wall Street - The Departed
Thea Sharrock --> Me Before You
Steven Spielberg --> Catch Me If You Can - The Terminal - The Post
Nick Cassavetes --> The Notebook
Nancy Meyers --> The Holiday
Spike Jonze --> Her
Richard Curtis --> About Time
Peter Weir --> The Truman Show
Wes Anderson --> The Grand Budapest Hotel
Quentin Tarantino --> Pulp Fiction - Once Upon A Time... In Hollywood
Francis Ford Coppola --> The Godfather
Clint Eastwood --> Unforgiven - Million Dollar Baby - Sully
David O. Russell --> Silver Linings Playbook - American Hustle
Lone Scherfig --> One Day
Brian Klugman --> The Words
Lee Sternthal --> The Words
Nora Ephron --> You'Ve Got Mail
Jean-Marc Vallée --> Dallas Buyers Club
Damián Szifron --> Relatos Salvajes(Wild Tales)
Paul Greengrass --> Captain Phillips
Rian Johnson --> Knives Out
Brad Bird --> Ratatouille
Jan Pinkava --> Ratatouille
Tom Shadyac --> Liar Liar - Ace Ventura: Pet Detective - Bruce Almighty
Martin Brest --> Scent Of A Woman
Tony Kaye --> Detachment  - American History X
Gabriele Muccino --> The Pursuit Of Happyness - Seven Pounds
Stephen Chbosky --> Wonder
Ben Stiller --> The Cable Guy - The Secret Life Of Walter Mitty
Taika Waititi --> Jojo Rabbit
Bobby Farrelly --> Dumb And Dumber - Me, Myself & Irene - Dumb And Dumber To
Peter Farrelly --> Dumb And Dumber - Me, Myself & Irene - Dumb And Dumber To
Vince Gilligan --> El Camino: A Breaking Bad Movie
James Mcteigue --> V For Vendetta
Damien Chazelle --> La La Land
Sam Mendes --> Revolutionary Road - American Beauty
Chuck Russell --> The Mask
Edward Zwick --> Love & Other Drugs - Blood Diamond
Terry Gilliam --> Twelve Monkeys
Sharon Maguire --> Bridget Jones'S Baby - Bridget Jones'S Diary
David Silverman --> Monsters, Inc.
Pete Docter --> Monsters, Inc.
Beeban Kidron --> Bridget Jones: The Edge Of Reason
Steve Oedekerk --> Ace Ventura: When Nature Calls
Bill Paxton --> Frailty
Lasse Hallström --> What'S Eating Gilbert Grape
Todd Phillips --> Joker - The Hangover - Old School - The Hangover Part Ii
Jake Kasdan --> Bad Teacher
Steve Mcqueen --> 12 Years A Slave
Joel Schumacher --> The Number 23 - A Time To Kill - Batman Forever
Robert Luketic --> The Ugly Truth - 21 - Monster-In-Law
Will Gluck --> Friends With Benefits
Penny Marshall --> Big - A League Of Their Own
Rawson Marshall Thurber --> We'Re The Millers
Judd Apatow --> The 40 Year Old Virgin - Knocked Up
Harold Ramis --> Groundhog Day - Bedazzled
Ry Russo-Young --> Before I Fall
Donald Petrie --> How To Lose A Guy In 10 Days
Roman Polanski --> The Pianist
Andrew Stanton --> Finding Nemo
Lee Unkrich --> Finding Nemo
Fede Alvarez --> Don'T Breathe
Peyton Reed --> Yes Man
Dennis Dugan --> Just Go With It - Grown Ups - Big Daddy
Adam Mckay --> Vice - The Big Short
Peter Segal --> 50 First Dates - Get Smart - Anger Management
Jonathan Levine --> 50/50
Barry Levinson --> Rain Man
Dan Gilroy --> Nightcrawler
James Demonaco --> The Purge: Election Year - The Purge: Anarchy - The Purge
Gerard Mcmurray --> The First Purge
Noah Baumbach --> Marriage Story
Dean Parisot --> Fun With Dick And Jane
Nicholas Stoller --> Forgetting Sarah Marshall
Max Barbakow --> Palm Springs
Vince Marcello --> The Kissing Booth - The Kissing Booth 2
Greg Mottola --> Superbad
Jeff Nichols --> Mud
Roger Kumble --> After We Collided
Frank Coraci --> Blended - The Wedding Singer - Click
Mark Waters --> Mr. Popper'S Penguins - Mean Girls - Just Like Heaven
Marc Lawrence --> Two Weeks Notice
Anne Fletcher --> The Proposal - 27 Dresses
Mary Harron --> American Psycho
Ron Howard --> A Beautiful Mind
Gus Van Sant --> Good Will Hunting
Doug Liman --> Mr. & Mrs. Smith
James Mangold --> Ford V Ferrari - Knight And Day
Gore Verbinski --> Pirates Of The Caribbean: The Curse Of The Black Pearl
Tom Ford --> Nocturnal Animals
Kellen Moore --> Looks That Kill
Raja Gosnell --> Never Been Kissed
Edgar Wright --> Baby Driver - Shaun Of The Dead
Michael Bay --> Bad Boys - Bad Boys Ii
Shawn Levy --> Date Night
Greg Berlanti --> Life As We Know It
Alex Garland --> Ex Machina
Luke Greenfield --> The Girl Next Door
Glenn Ficarra --> Crazy, Stupid, Love. - Focus - I Love You Phillip Morris
John Requa --> Crazy, Stupid, Love. - Focus - I Love You Phillip Morris
John Whitesell --> Holidate
Andy Tennant --> The Bounty Hunter - Hitch
Pascal Chaumeil --> A Long Way Down
Brad Anderson --> The Machinist
James Wan --> The Conjuring
Will Speck --> The Switch
Josh Gordon --> The Switch
David Dobkin --> Wedding Crashers
Nicolas Winding Refn --> Drive
Joe Dante --> The 'Burbs
Paul Thomas Anderson --> The Master
Milos Forman --> Man On The Moon
Drew Goddard --> The Cabin In The Woods
Shane Black --> The Nice Guys
Seth Macfarlane --> Ted
Jake Szymanski --> Mike And Dave Need Wedding Dates
Tim Miller --> Deadpool
Cory Finley --> Bad Education
Charlie Kaufman --> Im Thinking Of Ending Things
Denis Villeneuve --> Enemy
Stanley Kubrick --> The Shining
Tom Vaughan --> What Happens In Vegas
John Hamburg --> Along Came Polly
Andrew Niccol --> In Time
Sean Penn --> Into The Wild
Kyle Newman --> Barely Lethal
Roger Michell --> Notting Hill
Corin Hardy --> The Nun
Louis Leterrier --> Now You See Me
Jenny Gage --> After
Jon M. Chu --> Now You See Me 2
Jonathan Dayton --> Little Miss Sunshine
Valerie Faris --> Little Miss Sunshine
Paul Weitz --> American Pie
Chris Weitz --> American Pie
Ridley Scott --> Matchstick Men
Bruce Beresford --> Driving Miss Daisy
John Lee Hancock --> Saving Mr. Banks
James L. Brooks --> As Good As It Gets
Peter Hedges --> Dan In Real Life
Dan Mazer --> Dirty Grandpa
Jeff Fowler --> Sonic The Hedgehog
Paul Feig --> The Heat
Ethan Coen --> The Big Lebowski
Joel Coen --> The Big Lebowski
Brad Silberling --> A Series Of Unfortunate Events
Antoine Fuqua --> Training Day
Alejandro G. Iñárritu --> Birdman Or (The Unexpected Virtue Of Ignorance)
Sean Anders --> That'S My Boy
Marjane Satrapi --> The Voices
Don Scardino --> The Incredible Burt Wonderstone
Henry Joost --> Project Power
Ariel Schulman --> Project Power
John Hughes --> The Breakfast Club
Ang Lee --> Gemini Man
Matthew Vaughn --> Kick-Ass
Galder Gaztelu-Urrutia --> El Hoyo (The Platform)
